C           100,      50,       0

NO ./path_to_the_north_texture
  F   254,   100,   0
WE         ./path_to_the_west_texture
 

    
   
SO ./path_to_the_south_texture
EA ./path_to_the_east_texture
        1111111111111111111111111
        1000000000110000000000001
        1011000001110000000000001
        1001000000000000000000001
101111111011000001110000000000001
100000000011000001110111111111101
11110111111111011100000010001
11110111111111011101010010001
11000000110101011100000010001
100000000000000011000000100011
10000000000000001101010010000
11000001110101011111011110N0111
01110111111010110111101000111
111111111111111111111111111
