C           20,      97,       195
NO ./path_to_the_north_texture
  F   96,   139,   255
WE         ./path_to_the_west_texture
SO ./path_to_the_south_texture
EA ./path_to_the_east_texture
        1111111111111111111111111
        1000000000110000000000001
        1011000001110000000000001
        1001000000000000000000001
111111111011000001110000000000001
100000000011000001110111111111111
11110111111111011100000010001
11110111111111011101010010001
11000001111111011100000010001
10000001000101001100000001001
10000001000101000011010100101
11000001010101000000010000001
10000001000001011000000010001
1000000000N000000110101001001
11000001000001111110111100001
11110111110111101111010001111
111111111111111111111111111
