C           100,      50,       0
NO ./path_to_the_north_texture
  F   254,   100,   0
WE         ./path_to_the_west_texture
SO ./path_to_the_south_texture
EA ./path_to_the_east_texture
        1111111111111111111111111
        1000000000110000000000001
        1011000001110000000000001
        1001000000000000000000001
111111111011000001110000000000001
100000000011000001110111111111111
11110111111111011100000010001
11110111111111011101010010001
11000000110101011100000010001
10000000000000001100000001001
10000000000000000011010100101
11000001111111111000000100001
10000001000001011000000010001
1000000100N001000110101001001
11000001000001111110111100001
11110111111111101111010001111
111111111111111111111111111
