C           180,      159,       204
NO ./assets/textures/space1.xpm
F           113,      128,      172
WE         ./assets/textures/space6.xpm
SO ./assets/textures/space7.xpm
EA ./assets/textures/space8.xpm

11111111111111111111111111111
10000000000011111100000000001
10000000111100000011110000001
10000011000000000000001100001
100E0000000000000000000000001
10000011000000000000001100001
10000000111100000011110000001
10000000000011111100000000001
11111111111111111111111111111
