C           130,      76,       119
NO ./assets/textures/BRICK_3D.xpm
F           231,      236,      239
WE         ./assets/textures/BRICK_3D.xpm
SO ./assets/textures/BRICK_3D.xpm
EA ./assets/textures/BRICK_3D.xpm
111111111111111111111111111111111111111111111111111111111111111111111111111111111
100000000001100000000000000000000000000000000000000000000000000001000000000000001
100110000011100000000000000000000000111100000000000000000000000001000000000000111
100010000000000000000000000000001111100100000000011110000000000001110000000011101
111111111011000001110000000000001000000000000000010010000000000000000001000000001
100000000011000001110111111111111000000000000000010010000000000000000000011000001
111101111111110111000000100000100000000000000000010010000000000000000001110000111
100001111111110111010100100000100000111000000000010010000111100000000000000000001
100000011111110111000000100000100000001111111000000000000000000000000000000000001
100000010001010011000000010001100000000000000100000001111000000000000000000111001
100000010001010000110101001000000000000000000100000001000000000000111110000100001
110000010101010000000100000000000000000000000100000001000000000000100000011110001
100000010000010110000000100000000111100000000100000001000000000000111111100000001
1000000000S0000001101010010000000000110111111100000001000000000000100001000000001
110000010000011111101111000011111000000001000000000001000000000000100010000000001
111101111101111011110100000000001000000001111111111111000000000000000100000000001
111111111111111111111111111111111000000001000000000000000000000001111000000000001
                                1111111111111111100000101111100000000000111111111
                                1000001000100000100000100000100000000000100000001
                                1000001000100000111111100000100000000000100000001
                                1000000000000000000000000000100000000000100000001
                                1111111111111111111000000000100000000000100000001
                                                  1000000000111111111111100000001
                                                  1000000000000000000000000000001
                                                  1111111111111111111111111111111