C           39,      76,       119
NO ./assets/textures/fractal5.xpm
F           210,      210,      239
WE         ./assets/textures/fractal1.xpm
SO ./assets/textures/fractal3.xpm
EA ./assets/textures/fractal6.xpm
        1111111111111111111111111
        10000000001100000000000S1
        1011000001110000000000001
        1001000000000000000000001
111111111011000001110000000000001
100000000011000001110111111111111
11110111111111011100000010001
11110111111111011101010010001
11000001111111011100000010001
10000001000101001100000001001
10000001000101000011010100101
11000001010101000000010000001
10000001000001111000000010001
10000000000001  1110101001001
11000001000001111110111100001
11110111110111101111010001111
111111111111111111111111111
