C           39,      76,       119
NO ./assets/textures/BRICK_3D.xpm
F           231,      236,      239
WE         ./assets/textures/BRICK_3D.xpm
SO ./assets/textures/BRICK_3D.xpm
EA ./assets/textures/BRICK_3D.xpm

111111111111111
100001000010001
10000010S001001
100000000000001
111110000001111
100000100001001
100001000010001
111111111111111
