C           39,      76,       119
NO ./assets/textures/BRICK_3D.xpm
F           231,      236,      239
WE         ./assets/textures/SLIME_1A.xpm
SO ./assets/textures/SUPPORT_2D.xpm
EA ./assets/textures/Tile1.xpm

111111111111111
100001000010001
10000000S001001
100000000000001
100000100000001
100000000001001
110000000010001
111111111111111
