C           89,      26,       119
NO ./assets/textures/SUPPORT_2D.xpm
F           231,      236,      239
WE         ./assets/textures/SLIME_1A.xpm
SO ./assets/textures/SUPPORT_3D.xpm
EA ./assets/textures/SLIME_1B.xpm

11111111111111111111
10000000000000000001
10111100011110011101
10100001100011000101
10101110100101011101
10110111101111101101
10100010010001000101
10100100000001000101
101011000N0011010101
10100111111111000101
10010000000000100001
10001011111110100001
10000101111101000001
10000011111110000001
10000000111100000001
10000000010000000001
10000000011100000001
10000000010100000001
10000000000100000001
11111111111111111111