C           39,      76,       119
NO ./assets/textures/Tile1.xpm
F           231,      236,      239
WE         ./assets/textures/Tile2.xpm
SO ./assets/textures/Tile5.xpm
EA ./assets/textures/Tile3.xpm
1111111111111111111111111111111111111111111111111111111111111111111111111111111111111111111111111111
1000000000000000000000000000000000000000000000000000000000000000000000000000000000000000000000000001
1000111111111111111111110000000000000011111111111111111111000001000000100000001000000100000010000001
1000000000000000000000000000000000000000000000000000000000000001000000100000001000000100000010000001
1000111111111111111111110000000000000011111111111111111111000001000000100000001000000100000010000001
1W00000000000000000000000000000000000000000000000000000000000001000000100000001000000100000010000001
1000111111111111111111110000000000000011111111111111111111000001000000100000001000000100000010000001
1000000000000000000000000000000000000000000000000000000000000001000000100000001000000100000010000001
1000111111111111111111110000000000000011111111111111111111000001000000100000001000000100000010000001
1000000000000000000000000000000000000000000000000000000000000001000000100000001000000100000010000001
1000111111111111111111110000000000000011111111111111111111000001000000100000001000000100000010000001
1000000000000000000000000000000000000000000000000000000000000000000000000000000000000000000000000001
1111111111111111111111111111111111111111111111111111111111111111111111111111111111111111111111111111
