C           39,      76,       119
F           231,      236,      239
NO ./assets/textures/SLIME_1B.xpm
SO ./assets/textures/SLIME_1A.xpm
WE ./assets/textures/fractal1.xpm
EA ./assets/textures/fractal6.xpm

1111111111111111111111111111111111111111
1E00000000000000000100000000000000000001
1111111110000000000100000000000111100001
1000000000011111111101010111101110000011
1111111110000000000111100000000000000011
1000000000011111111100000000000011111001
1111111110000000000111000110001100000101
1000000000011111111111110000000011100001
1111111110000000000100000001111100000001
1000000000011111111111100000000011100001
1111111110000000000100000000000011111001
1000000000011111111100000111111111000001
1000000000000000000000000000000000000001
1000000000000000000000000000000000000001
1111111111111111111111111111111111111111