C           39a,      76, 43
NO ./textures/BRICK_3D.xpm
F           231,      236,      239
WE         ./textures/BRICK_3D.xpm
SO ./textures/BRICK_3D.xpm
EA ./textures/BRICK_3D.xpm

11111111111111111111111111111
10000000000011111100000000001
10000000111100000011110000001
10000011000000000000001100001
10000000000000S00000000000001
10000011000000000000001100001
10000000111100000011110000001
10000000000011111100000000001
11111111111111111111111111111