C           39,      76,       119
NO ./textures/BRICK_3D.xpm
F           231,      236,      239
WE         ./textures/BRICK_3D.xpm
SO ./textures/BRICK_3D.xpm
EA ./textures/BRICK_3D.xpm

111111111111111111111111111111111111111111111
110000000010000000000000000000000010000000011
101000000001000000000000000000000100000000101
100100000000100000000000000000001000000001001
100010000000010000000000000000010000000010001
10000100E000000111111111111111000000001000001
100001000000010000000000000000010000000100001
100010000000100000000000000000001000000010001
100100000001000000000000000000000100000001001
101000000010000000000000000000000010000000101
111111111111111111111111111111111111111111111
