C          39,      76,       119
NO ./textures/BRICK_3D.xpm
F    231,      236,      239
WE      ./textures/BRICK_3D.xpm
SO ./textures/BRICK_3D.xpm
EA ./textures/BRICK_3D.xpm


1111111111
1E00000001
1111000001
1000001111
1111000001
1000001111
1111000001
1000001111
1111000001
1000001111
1111000001
1000000001
1111111111